11111111111111111111
1             	   1
1 2  00   0000222  1
1 2         33332  1
1 2  22	      232  1
1 2            32  1
1 2            32  1
1 23           32  1
1 2322       3232  1
1 232233333333232  1 
1 232222222222232  1
1 233333333333332  1
1 222222222222222  1
1 333333333333333  1
1 222222222222222  1
1  				   1
1                  1			   
1				   1
1				   1
11111111111111111111