+r-+r-+r-+s-+-r+
|           r  g
+  +r-+s-+  +  +
r  |     r     |
+  +s-+  +--+  +
r     |     o  |
+e-+  +--+  +  +
g     |  |     o
+  +r-+  +  +--+
|        |   . d 
+r-+e-+c-+w-+oo+